11111111111111111
1C0100010E0000C01
1100C010100000001
110C00P000100S001
11C01010010000101
11111111111111111
