11111111111111111
1C01111C050000C01
11000P1E10S000001
11000000000000001
11111111111111111
